1111111111111111
1000000000000001
1000000000000001
1000000000000001
1000000000000001
1000000000000001
1000000000100001
1000000000630001
1000000000600001
1000000000600001
1000000000600001
1000000000H00001
1000000000K00001
10000T0000T00001
1000020s00000001
1111111111111111