1111111111111111
1s00661616666161
1444666666666661
1004666661666661
1004666666666611
1004616666661661
1004666666666611
1004444444044441
100t400330200001
1000H00330000001
1440400330000001
166640033000T201
1666111111111111
100001tH01K001T1
1K000101G1000001
1111111111111111