1111111111111111
1s00000000023001
1111111110111111
1303000310010001
1303030310010101
1300030000010101
1111111115110101
1003000300010131
1300030003010131
1111111333010131
1f00001333000131
1000001333333131
1114111111111101
1000000002001101
1000000000000001
1111111111111111
