1111111111111111
1000000000200001
1111111110111111
1000s00010010001
1000220010010101
1000000000010101
1111111110110101
1000000000010101
1000000000010101
1111111000010101
1000001000000101
1000001000000101
1110111111111101
1000000000001101
1000000000000001
1111111111111111