1111111111111111
1000000000200001
1111111110111111
1000000010010001
1300220010010101
1340000000010101
1111111113110101
1066557733310101
1008000332310101
111111132s313101
100G001332323101
1000001033333101
1110111111111101
1000000000001101
1009A00000000001
1111111111111111