1111111111111111
1666666661666661
1666166666666661
1666666666166661
1616666666666661
1166666661666661
1666666666666611
1666666166666661
16616666666666s1
1666666666666611
1666666616666661
1666661666166661
1666666666666661
1666666666666661
16666666666666G1
1111111111111111